WE  textures/west.xpm
SO  textures/south.xpm
EA  textures/east.xpm
NO  textures/north.xpm

F  0,0,0
C  255,255,255

1111
1001
10N1
1111
