SO  ./textures/south.xpm
EA  ./textures/east.xpm
NO  ./textures/north.xpm
WE  ./textures/west.xpm

F    250,100,0
C    255,30,0


        1111111111111111111111111
        1000000000110000000000001
        1011000001110000000000001
        1001000000000000000000001
111111111011000001110000000000001
100000000011000001110111111111111
11110111111111011100000010001
11110111111111011101010010001
11000000110101011100000010001
10000000000000001100000010001
1000000000000000110101001000111
1100000111101010111111011110N01
11110111  1110101  101111000001
11111111  1111111  111111111111
